"filename", "language", "TypeScript", "HTML", "Vue", "SCSS", "Markdown", "comment", "blank", "total"
"/Users/peaker/dev/solar-finance/src/App.vue", "Vue", 0, 0, 46, 0, 0, 1, 4, 51
"/Users/peaker/dev/solar-finance/src/about/BaseIconStructur.md", "Markdown", 0, 0, 0, 0, 51, 0, 3, 54
"/Users/peaker/dev/solar-finance/src/about/Description.md", "Markdown", 0, 0, 0, 0, 58, 0, 28, 86
"/Users/peaker/dev/solar-finance/src/about/WorkFlow/BaseStores.md", "Markdown", 0, 0, 0, 0, 169, 0, 52, 221
"/Users/peaker/dev/solar-finance/src/about/WorkFlow/BookView.md", "Markdown", 0, 0, 0, 0, 77, 0, 47, 124
"/Users/peaker/dev/solar-finance/src/about/WorkFlow/DistributionRules.md", "Markdown", 0, 0, 0, 0, 606, 0, 140, 746
"/Users/peaker/dev/solar-finance/src/about/WorkFlow/MainPlan.md", "Markdown", 0, 0, 0, 0, 468, 0, 151, 619
"/Users/peaker/dev/solar-finance/src/about/WorkFlow/Mock.md", "Markdown", 0, 0, 0, 0, 1306, 0, 68, 1374
"/Users/peaker/dev/solar-finance/src/about/main.md", "Markdown", 0, 0, 0, 0, 653, 0, 121, 774
"/Users/peaker/dev/solar-finance/src/assets/theme-test.html", "HTML", 0, 0, 0, 0, 0, 0, 1, 1
"/Users/peaker/dev/solar-finance/src/composables/transaction/useFormatBalance.ts", "TypeScript", 126, 0, 0, 0, 0, 42, 25, 193
"/Users/peaker/dev/solar-finance/src/composables/ui/useClickOutside.ts", "TypeScript", 24, 0, 0, 0, 0, 6, 6, 36
"/Users/peaker/dev/solar-finance/src/composables/ui/useDropdown.ts", "TypeScript", 38, 0, 0, 0, 0, 4, 9, 51
"/Users/peaker/dev/solar-finance/src/composables/ui/useGridLayout.ts", "TypeScript", 106, 0, 0, 0, 0, 23, 25, 154
"/Users/peaker/dev/solar-finance/src/composables/ui/useGridLayoutTypes.ts", "TypeScript", 34, 0, 0, 0, 0, 1, 6, 41
"/Users/peaker/dev/solar-finance/src/composables/ui/useTruncateText.ts", "TypeScript", 65, 0, 0, 0, 0, 49, 16, 130
"/Users/peaker/dev/solar-finance/src/composables/useDateFilter.ts", "TypeScript", 382, 0, 0, 0, 0, 69, 83, 534
"/Users/peaker/dev/solar-finance/src/composables/useSimpleTheme.ts", "TypeScript", 40, 0, 0, 0, 0, 18, 15, 73
"/Users/peaker/dev/solar-finance/src/constants/transactionTypes.ts", "TypeScript", 26, 0, 0, 0, 0, 6, 6, 38
"/Users/peaker/dev/solar-finance/src/layouts/ConsoleLayout.vue", "Vue", 0, 0, 70, 0, 0, 3, 9, 82
"/Users/peaker/dev/solar-finance/src/layouts/EmptyLayout.vue", "Vue", 0, 0, 15, 0, 0, 0, 2, 17
"/Users/peaker/dev/solar-finance/src/layouts/IosLayout.vue", "Vue", 0, 0, 163, 0, 0, 1, 25, 189
"/Users/peaker/dev/solar-finance/src/main.ts", "TypeScript", 55, 0, 0, 0, 0, 16, 18, 89
"/Users/peaker/dev/solar-finance/src/router/index.ts", "TypeScript", 171, 0, 0, 0, 0, 17, 10, 198
"/Users/peaker/dev/solar-finance/src/services/BaseCrudService.ts", "TypeScript", 54, 0, 0, 0, 0, 22, 11, 87
"/Users/peaker/dev/solar-finance/src/services/api/ApiService.ts", "TypeScript", 6, 0, 0, 0, 0, 1, 4, 11
"/Users/peaker/dev/solar-finance/src/services/api/LocalStorageApiService.ts", "TypeScript", 76, 0, 0, 0, 0, 30, 32, 138
"/Users/peaker/dev/solar-finance/src/services/system/AppInitService.ts", "TypeScript", 60, 0, 0, 0, 0, 28, 14, 102
"/Users/peaker/dev/solar-finance/src/services/system/MessageService.ts", "TypeScript", 54, 0, 0, 0, 0, 33, 11, 98
"/Users/peaker/dev/solar-finance/src/stores/account/accountService.ts", "TypeScript", 90, 0, 0, 0, 0, 27, 13, 130
"/Users/peaker/dev/solar-finance/src/stores/account/accountStore.ts", "TypeScript", 412, 0, 0, 0, 0, 126, 101, 639
"/Users/peaker/dev/solar-finance/src/stores/account/defaultAccounts.ts", "TypeScript", 117, 0, 0, 0, 0, 6, 0, 123
"/Users/peaker/dev/solar-finance/src/stores/account/index.ts", "TypeScript", 4, 0, 0, 0, 0, 2, 1, 7
"/Users/peaker/dev/solar-finance/src/stores/account/types.ts", "TypeScript", 20, 0, 0, 0, 0, 3, 4, 27
"/Users/peaker/dev/solar-finance/src/stores/book/bookService.ts", "TypeScript", 77, 0, 0, 0, 0, 24, 12, 113
"/Users/peaker/dev/solar-finance/src/stores/book/bookStore.ts", "TypeScript", 129, 0, 0, 0, 0, 32, 26, 187
"/Users/peaker/dev/solar-finance/src/stores/book/defaultBooks.ts", "TypeScript", 43, 0, 0, 0, 0, 5, 1, 49
"/Users/peaker/dev/solar-finance/src/stores/book/index.ts", "TypeScript", 4, 0, 0, 0, 0, 2, 1, 7
"/Users/peaker/dev/solar-finance/src/stores/book/types.ts", "TypeScript", 19, 0, 0, 0, 0, 1, 2, 22
"/Users/peaker/dev/solar-finance/src/stores/category/categoryService.ts", "TypeScript", 248, 0, 0, 0, 0, 66, 58, 372
"/Users/peaker/dev/solar-finance/src/stores/category/categoryStore.ts", "TypeScript", 133, 0, 0, 0, 0, 16, 44, 193
"/Users/peaker/dev/solar-finance/src/stores/category/defaultCategories.ts", "TypeScript", 255, 0, 0, 0, 0, 10, 9, 274
"/Users/peaker/dev/solar-finance/src/stores/category/index.ts", "TypeScript", 12, 0, 0, 0, 0, 6, 6, 24
"/Users/peaker/dev/solar-finance/src/stores/category/types.ts", "TypeScript", 23, 0, 0, 0, 0, 6, 3, 32
"/Users/peaker/dev/solar-finance/src/stores/common/types.ts", "TypeScript", 9, 0, 0, 0, 0, 1, 1, 11
"/Users/peaker/dev/solar-finance/src/stores/currency/currencyService.ts", "TypeScript", 102, 0, 0, 0, 0, 24, 26, 152
"/Users/peaker/dev/solar-finance/src/stores/currency/currencyStore.ts", "TypeScript", 180, 0, 0, 0, 0, 30, 37, 247
"/Users/peaker/dev/solar-finance/src/stores/currency/defaultCurrencies.ts", "TypeScript", 50, 0, 0, 0, 0, 2, 2, 54
"/Users/peaker/dev/solar-finance/src/stores/currency/index.ts", "TypeScript", 3, 0, 0, 0, 0, 3, 1, 7
"/Users/peaker/dev/solar-finance/src/stores/currency/types.ts", "TypeScript", 25, 0, 0, 0, 0, 1, 3, 29
"/Users/peaker/dev/solar-finance/src/stores/system/composables/useApp.ts", "TypeScript", 37, 0, 0, 0, 0, 21, 9, 67
"/Users/peaker/dev/solar-finance/src/stores/system/composables/usePlatform.ts", "TypeScript", 45, 0, 0, 0, 0, 17, 11, 73
"/Users/peaker/dev/solar-finance/src/stores/system/composables/useViewport.ts", "TypeScript", 56, 0, 0, 0, 0, 27, 17, 100
"/Users/peaker/dev/solar-finance/src/stores/system/constants.ts", "TypeScript", 35, 0, 0, 0, 0, 13, 4, 52
"/Users/peaker/dev/solar-finance/src/stores/system/index.ts", "TypeScript", 4, 0, 0, 0, 0, 3, 2, 9
"/Users/peaker/dev/solar-finance/src/stores/system/systemStore.ts", "TypeScript", 211, 0, 0, 0, 0, 96, 45, 352
"/Users/peaker/dev/solar-finance/src/stores/system/types.ts", "TypeScript", 11, 0, 0, 0, 0, 1, 3, 15
"/Users/peaker/dev/solar-finance/src/stores/theme.ts", "TypeScript", 82, 0, 0, 0, 0, 16, 14, 112
"/Users/peaker/dev/solar-finance/src/stores/transaction/defaultTransactions.ts", "TypeScript", 741, 0, 0, 0, 0, 22, 17, 780
"/Users/peaker/dev/solar-finance/src/stores/transaction/index.ts", "TypeScript", 4, 0, 0, 0, 0, 2, 1, 7
"/Users/peaker/dev/solar-finance/src/stores/transaction/transactionService.ts", "TypeScript", 72, 0, 0, 0, 0, 20, 11, 103
"/Users/peaker/dev/solar-finance/src/stores/transaction/transactionStore.ts", "TypeScript", 170, 0, 0, 0, 0, 45, 39, 254
"/Users/peaker/dev/solar-finance/src/stores/transaction/types.ts", "TypeScript", 25, 0, 0, 0, 0, 7, 8, 40
"/Users/peaker/dev/solar-finance/src/stores/user/defaultUsers.ts", "TypeScript", 37, 0, 0, 0, 0, 6, 1, 44
"/Users/peaker/dev/solar-finance/src/stores/user/index.ts", "TypeScript", 4, 0, 0, 0, 0, 2, 1, 7
"/Users/peaker/dev/solar-finance/src/stores/user/types.ts", "TypeScript", 17, 0, 0, 0, 0, 2, 2, 21
"/Users/peaker/dev/solar-finance/src/stores/user/userService.ts", "TypeScript", 140, 0, 0, 0, 0, 52, 23, 215
"/Users/peaker/dev/solar-finance/src/stores/user/userStore.ts", "TypeScript", 171, 0, 0, 0, 0, 60, 41, 272
"/Users/peaker/dev/solar-finance/src/styles/_mixins.scss", "SCSS", 0, 0, 0, 20, 0, 1, 3, 24
"/Users/peaker/dev/solar-finance/src/styles/components/_forms.scss", "SCSS", 0, 0, 0, 137, 0, 16, 25, 178
"/Users/peaker/dev/solar-finance/src/styles/components/_inputs.scss", "SCSS", 0, 0, 0, 30, 0, 1, 3, 34
"/Users/peaker/dev/solar-finance/src/styles/main.scss", "SCSS", 0, 0, 0, 76, 0, 14, 18, 108
"/Users/peaker/dev/solar-finance/src/styles/themes/_colors.scss", "SCSS", 0, 0, 0, 58, 0, 15, 13, 86
"/Users/peaker/dev/solar-finance/src/styles/themes/_dark.scss", "SCSS", 0, 0, 0, 35, 0, 12, 10, 57
"/Users/peaker/dev/solar-finance/src/styles/themes/_light.scss", "SCSS", 0, 0, 0, 35, 0, 12, 10, 57
"/Users/peaker/dev/solar-finance/src/styles/themes/_typography.scss", "SCSS", 0, 0, 0, 66, 0, 13, 17, 96
"/Users/peaker/dev/solar-finance/src/styles/themes/_variables.scss", "SCSS", 0, 0, 0, 52, 0, 17, 14, 83
"/Users/peaker/dev/solar-finance/src/types/base.ts", "TypeScript", 5, 0, 0, 0, 0, 0, 0, 5
"/Users/peaker/dev/solar-finance/src/utils/debounce.ts", "TypeScript", 16, 0, 0, 0, 0, 9, 4, 29
"/Users/peaker/dev/solar-finance/src/views/AccountsView.vue", "Vue", 0, 0, 184, 0, 0, 4, 24, 212
"/Users/peaker/dev/solar-finance/src/views/DashboardView.vue", "Vue", 0, 0, 221, 0, 0, 4, 19, 244
"/Users/peaker/dev/solar-finance/src/views/DebugStoreView.vue", "Vue", 0, 0, 643, 0, 0, 4, 59, 706
"/Users/peaker/dev/solar-finance/src/views/MoreView.vue", "Vue", 0, 0, 252, 0, 0, 8, 33, 293
"/Users/peaker/dev/solar-finance/src/views/NotFoundView.vue", "Vue", 0, 0, 32, 0, 0, 1, 4, 37
"/Users/peaker/dev/solar-finance/src/views/PinLoginView.vue", "Vue", 0, 0, 223, 0, 0, 5, 37, 265
"/Users/peaker/dev/solar-finance/src/views/account/popup/AccountAddPopup.vue", "Vue", 0, 0, 366, 0, 0, 13, 52, 431
"/Users/peaker/dev/solar-finance/src/views/account/popup/AccountEditPopup.vue", "Vue", 0, 0, 410, 0, 0, 11, 58, 479
"/Users/peaker/dev/solar-finance/src/views/account/popup/AccountSelectorPopup.vue", "Vue", 0, 0, 485, 0, 0, 13, 82, 580
"/Users/peaker/dev/solar-finance/src/views/account/popup/BookAccountsPopup.vue", "Vue", 0, 0, 471, 0, 0, 6, 93, 570
"/Users/peaker/dev/solar-finance/src/views/account/popup/components/AccountIcon.vue", "Vue", 0, 0, 107, 0, 0, 3, 14, 124
"/Users/peaker/dev/solar-finance/src/views/account/popup/components/AccountSharingPicker.vue", "Vue", 0, 0, 186, 0, 0, 1, 30, 217
"/Users/peaker/dev/solar-finance/src/views/account/popup/components/AccountTypeSelector.vue", "Vue", 0, 0, 151, 0, 0, 1, 25, 177
"/Users/peaker/dev/solar-finance/src/views/account/popup/composables/useAccountManagement.ts", "TypeScript", 76, 0, 0, 0, 0, 18, 20, 114
"/Users/peaker/dev/solar-finance/src/views/account/popup/composables/useAccountSharing.ts", "TypeScript", 50, 0, 0, 0, 0, 23, 10, 83
"/Users/peaker/dev/solar-finance/src/views/account/popup/composables/useAccountTypes.ts", "TypeScript", 84, 0, 0, 0, 0, 36, 10, 130
"/Users/peaker/dev/solar-finance/src/views/book/page/BooksView.vue", "Vue", 0, 0, 72, 0, 0, 7, 17, 96
"/Users/peaker/dev/solar-finance/src/views/book/page/components/BookFilterView.vue", "Vue", 0, 0, 52, 0, 0, 1, 10, 63
"/Users/peaker/dev/solar-finance/src/views/book/page/components/BookFinanceSummary.vue", "Vue", 0, 0, 359, 0, 0, 16, 60, 435
"/Users/peaker/dev/solar-finance/src/views/book/page/components/BookHeader.vue", "Vue", 0, 0, 36, 0, 0, 1, 7, 44
"/Users/peaker/dev/solar-finance/src/views/book/page/components/BookPercentageSlider.vue", "Vue", 0, 0, 281, 0, 0, 8, 40, 329
"/Users/peaker/dev/solar-finance/src/views/book/page/components/BookTransactionGroup.vue", "Vue", 0, 0, 63, 0, 0, 1, 11, 75
"/Users/peaker/dev/solar-finance/src/views/book/page/components/BookTransactionItem.vue", "Vue", 0, 0, 178, 0, 0, 1, 38, 217
"/Users/peaker/dev/solar-finance/src/views/book/page/components/BookTransactionsList.vue", "Vue", 0, 0, 62, 0, 0, 1, 11, 74
"/Users/peaker/dev/solar-finance/src/views/book/page/components/DashBoardBook.vue", "Vue", 0, 0, 25, 0, 0, 0, 4, 29
"/Users/peaker/dev/solar-finance/src/views/book/page/composables/useBookContext.ts", "TypeScript", 255, 0, 0, 0, 0, 47, 58, 360
"/Users/peaker/dev/solar-finance/src/views/book/page/composables/useBookFinanceSummary.ts", "TypeScript", 132, 0, 0, 0, 0, 23, 31, 186
"/Users/peaker/dev/solar-finance/src/views/book/page/composables/useBookSelect.ts", "TypeScript", 105, 0, 0, 0, 0, 15, 20, 140
"/Users/peaker/dev/solar-finance/src/views/book/page/composables/useBookTransactions.ts", "TypeScript", 48, 0, 0, 0, 0, 8, 13, 69
"/Users/peaker/dev/solar-finance/src/views/book/page/composables/usePercentageSlider.ts", "TypeScript", 207, 0, 0, 0, 0, 43, 61, 311
"/Users/peaker/dev/solar-finance/src/views/book/popup/EditBookPopup.vue", "Vue", 0, 0, 35, 0, 0, 1, 5, 41
"/Users/peaker/dev/solar-finance/src/views/book/popup/NewBookPopup.vue", "Vue", 0, 0, 30, 0, 0, 1, 5, 36
"/Users/peaker/dev/solar-finance/src/views/currency/popup/CurrencyPopup.vue", "Vue", 0, 0, 162, 0, 0, 3, 25, 190
"/Users/peaker/dev/solar-finance/src/views/icon/popup/IconSelectorPopup.vue", "Vue", 0, 0, 361, 0, 0, 6, 52, 419
"/Users/peaker/dev/solar-finance/src/views/profile/pages/ProfileView.vue", "Vue", 0, 0, 95, 0, 0, 1, 18, 114
"/Users/peaker/dev/solar-finance/src/views/profile/pages/composables/useSimpleTheme.ts", "TypeScript", 50, 0, 0, 0, 0, 20, 17, 87
"/Users/peaker/dev/solar-finance/src/views/profile/pages/composables/useTheme.ts", "TypeScript", 36, 0, 0, 0, 0, 15, 13, 64
"/Users/peaker/dev/solar-finance/src/views/transaction/TransactionView.vue", "Vue", 0, 0, 588, 0, 0, 8, 96, 692
"/Users/peaker/dev/solar-finance/src/views/transaction/components/AccountSelector.vue", "Vue", 0, 0, 195, 0, 0, 2, 29, 226
"/Users/peaker/dev/solar-finance/src/views/transaction/components/AmountSection.vue", "Vue", 0, 0, 190, 0, 0, 5, 24, 219
"/Users/peaker/dev/solar-finance/src/views/transaction/components/BookSelector.vue", "Vue", 0, 0, 135, 0, 0, 1, 19, 155
"/Users/peaker/dev/solar-finance/src/views/transaction/components/NumberKeypad.vue", "Vue", 0, 0, 147, 0, 0, 1, 17, 165
"/Users/peaker/dev/solar-finance/src/views/transaction/components/PercentageSlider.vue", "Vue", 0, 0, 57, 0, 0, 3, 8, 68
"/Users/peaker/dev/solar-finance/src/views/transaction/components/TransactionTypeSelector.vue", "Vue", 0, 0, 173, 0, 0, 3, 26, 202
"/Users/peaker/dev/solar-finance/src/views/transaction/composables/index.ts", "TypeScript", 6, 0, 0, 0, 0, 2, 1, 9
"/Users/peaker/dev/solar-finance/src/views/transaction/composables/useAccount.ts", "TypeScript", 132, 0, 0, 0, 0, 37, 27, 196
"/Users/peaker/dev/solar-finance/src/views/transaction/composables/useCategory.ts", "TypeScript", 74, 0, 0, 0, 0, 22, 17, 113
"/Users/peaker/dev/solar-finance/src/views/transaction/composables/useCurrency.ts", "TypeScript", 148, 0, 0, 0, 0, 48, 34, 230
"/Users/peaker/dev/solar-finance/src/views/transaction/composables/useDistribution.ts", "TypeScript", 53, 0, 0, 0, 0, 17, 11, 81
"/Users/peaker/dev/solar-finance/src/views/transaction/composables/useDistributionControl.ts", "TypeScript", 67, 0, 0, 0, 0, 32, 16, 115
"/Users/peaker/dev/solar-finance/src/views/transaction/composables/useKeypad.ts", "TypeScript", 38, 0, 0, 0, 0, 22, 7, 67
"/Users/peaker/dev/solar-finance/src/views/transaction/composables/useTransaction.ts", "TypeScript", 139, 0, 0, 0, 0, 27, 27, 193
"Total", "-", 6855, 0, 7321, 509, 3388, 1885, 3104, 23062