"filename", "language", "TypeScript", "Vue", "Markdown", "comment", "blank", "total"
"/Users/peaker/dev/solar-finance/src/App.vue", "Vue", 0, 108, 0, 0, 11, 119
"/Users/peaker/dev/solar-finance/src/about/Description.md", "Markdown", 0, 0, 58, 0, 28, 86
"/Users/peaker/dev/solar-finance/src/about/WorkFlow/BaseStores.md", "Markdown", 0, 0, 169, 0, 52, 221
"/Users/peaker/dev/solar-finance/src/about/WorkFlow/MainPlan.md", "Markdown", 0, 0, 468, 0, 151, 619
"/Users/peaker/dev/solar-finance/src/about/WorkFlow/Mock.md", "Markdown", 0, 0, 1306, 0, 68, 1374
"/Users/peaker/dev/solar-finance/src/about/main.md", "Markdown", 0, 0, 653, 0, 121, 774
"/Users/peaker/dev/solar-finance/src/components/categories/CategoryAddPopup.vue", "Vue", 0, 359, 0, 9, 45, 413
"/Users/peaker/dev/solar-finance/src/components/categories/CategoryEditPopup.vue", "Vue", 0, 444, 0, 10, 60, 514
"/Users/peaker/dev/solar-finance/src/components/categories/CategoryFilterToggle.vue", "Vue", 0, 59, 0, 1, 10, 70
"/Users/peaker/dev/solar-finance/src/components/categories/CategoryIcon.vue", "Vue", 0, 83, 0, 1, 14, 98
"/Users/peaker/dev/solar-finance/src/components/categories/CategoryItem.vue", "Vue", 0, 109, 0, 1, 16, 126
"/Users/peaker/dev/solar-finance/src/components/categories/CategoryListGrouped.vue", "Vue", 0, 96, 0, 3, 15, 114
"/Users/peaker/dev/solar-finance/src/components/categories/CategoryListPopup.vue", "Vue", 0, 400, 0, 13, 68, 481
"/Users/peaker/dev/solar-finance/src/components/categories/CategorySelector.vue", "Vue", 0, 258, 0, 5, 35, 298
"/Users/peaker/dev/solar-finance/src/components/categories/CategoryViewPopup.vue", "Vue", 0, 426, 0, 12, 77, 515
"/Users/peaker/dev/solar-finance/src/components/categories/view/CategoryDateFilters.vue", "Vue", 0, 85, 0, 2, 13, 100
"/Users/peaker/dev/solar-finance/src/components/categories/view/CategoryTransactionsList.vue", "Vue", 0, 150, 0, 3, 18, 171
"/Users/peaker/dev/solar-finance/src/components/currency/CurrencySelector.vue", "Vue", 0, 146, 0, 0, 23, 169
"/Users/peaker/dev/solar-finance/src/components/navigation/NavMenu.vue", "Vue", 0, 96, 0, 1, 4, 101
"/Users/peaker/dev/solar-finance/src/components/transactions/AccountSelector.vue", "Vue", 0, 219, 0, 4, 29, 252
"/Users/peaker/dev/solar-finance/src/components/transactions/BookSelector.vue", "Vue", 0, 135, 0, 1, 19, 155
"/Users/peaker/dev/solar-finance/src/components/transactions/NumberKeypad.vue", "Vue", 0, 123, 0, 2, 12, 137
"/Users/peaker/dev/solar-finance/src/components/transactions/PercentageSlider.vue", "Vue", 0, 162, 0, 1, 21, 184
"/Users/peaker/dev/solar-finance/src/components/transactions/TransactionTypeSelector.vue", "Vue", 0, 82, 0, 1, 11, 94
"/Users/peaker/dev/solar-finance/src/components/transactions/ViewTransaction/TransactionDateGroup.vue", "Vue", 0, 90, 0, 3, 14, 107
"/Users/peaker/dev/solar-finance/src/components/transactions/ViewTransaction/TransactionItem.vue", "Vue", 0, 228, 0, 4, 31, 263
"/Users/peaker/dev/solar-finance/src/components/ui/BasePopup.vue", "Vue", 0, 195, 0, 6, 9, 210
"/Users/peaker/dev/solar-finance/src/components/ui/CreateCategoryButton.vue", "Vue", 0, 44, 0, 1, 6, 51
"/Users/peaker/dev/solar-finance/src/components/ui/filters/DateFilter.vue", "Vue", 0, 438, 0, 11, 62, 511
"/Users/peaker/dev/solar-finance/src/components/ui/inputs/ColorPicker.vue", "Vue", 0, 63, 0, 1, 12, 76
"/Users/peaker/dev/solar-finance/src/components/ui/inputs/IconPicker.vue", "Vue", 0, 61, 0, 1, 8, 70
"/Users/peaker/dev/solar-finance/src/components/ui/inputs/ParentCategorySelector.vue", "Vue", 0, 121, 0, 1, 17, 139
"/Users/peaker/dev/solar-finance/src/components/ui/inputs/TextInput.vue", "Vue", 0, 54, 0, 1, 7, 62
"/Users/peaker/dev/solar-finance/src/components/ui/inputs/ToggleButtonGroup.vue", "Vue", 0, 64, 0, 1, 7, 72
"/Users/peaker/dev/solar-finance/src/components/ui/inputs/ToggleSwitch.vue", "Vue", 0, 47, 0, 1, 7, 55
"/Users/peaker/dev/solar-finance/src/composables/useDateFilter.ts", "TypeScript", 330, 0, 0, 43, 64, 437
"/Users/peaker/dev/solar-finance/src/data/categories.ts", "TypeScript", 110, 0, 0, 11, 26, 147
"/Users/peaker/dev/solar-finance/src/layouts/ConsoleLayout.vue", "Vue", 0, 70, 0, 3, 9, 82
"/Users/peaker/dev/solar-finance/src/layouts/EmptyLayout.vue", "Vue", 0, 15, 0, 0, 2, 17
"/Users/peaker/dev/solar-finance/src/layouts/IosLayout.vue", "Vue", 0, 63, 0, 1, 10, 74
"/Users/peaker/dev/solar-finance/src/main.ts", "TypeScript", 23, 0, 0, 9, 10, 42
"/Users/peaker/dev/solar-finance/src/router/index.ts", "TypeScript", 124, 0, 0, 15, 10, 149
"/Users/peaker/dev/solar-finance/src/services/BaseCrudService.ts", "TypeScript", 54, 0, 0, 22, 11, 87
"/Users/peaker/dev/solar-finance/src/services/api/ApiService.ts", "TypeScript", 6, 0, 0, 1, 4, 11
"/Users/peaker/dev/solar-finance/src/services/api/LocalStorageApiService.ts", "TypeScript", 76, 0, 0, 30, 32, 138
"/Users/peaker/dev/solar-finance/src/stores/account/accountService.ts", "TypeScript", 90, 0, 0, 27, 13, 130
"/Users/peaker/dev/solar-finance/src/stores/account/accountStore.ts", "TypeScript", 364, 0, 0, 103, 86, 553
"/Users/peaker/dev/solar-finance/src/stores/account/defaultAccounts.ts", "TypeScript", 108, 0, 0, 6, 0, 114
"/Users/peaker/dev/solar-finance/src/stores/account/index.ts", "TypeScript", 4, 0, 0, 2, 1, 7
"/Users/peaker/dev/solar-finance/src/stores/account/types.ts", "TypeScript", 17, 0, 0, 1, 1, 19
"/Users/peaker/dev/solar-finance/src/stores/book/bookService.ts", "TypeScript", 77, 0, 0, 24, 12, 113
"/Users/peaker/dev/solar-finance/src/stores/book/bookStore.ts", "TypeScript", 129, 0, 0, 32, 26, 187
"/Users/peaker/dev/solar-finance/src/stores/book/defaultBooks.ts", "TypeScript", 40, 0, 0, 5, 1, 46
"/Users/peaker/dev/solar-finance/src/stores/book/index.ts", "TypeScript", 4, 0, 0, 2, 1, 7
"/Users/peaker/dev/solar-finance/src/stores/book/types.ts", "TypeScript", 18, 0, 0, 1, 2, 21
"/Users/peaker/dev/solar-finance/src/stores/category/categoryService.ts", "TypeScript", 248, 0, 0, 66, 58, 372
"/Users/peaker/dev/solar-finance/src/stores/category/categoryStore.ts", "TypeScript", 133, 0, 0, 16, 44, 193
"/Users/peaker/dev/solar-finance/src/stores/category/defaultCategories.ts", "TypeScript", 255, 0, 0, 10, 9, 274
"/Users/peaker/dev/solar-finance/src/stores/category/index.ts", "TypeScript", 12, 0, 0, 6, 6, 24
"/Users/peaker/dev/solar-finance/src/stores/category/types.ts", "TypeScript", 23, 0, 0, 6, 3, 32
"/Users/peaker/dev/solar-finance/src/stores/common/types.ts", "TypeScript", 9, 0, 0, 1, 1, 11
"/Users/peaker/dev/solar-finance/src/stores/currency/currencyService.ts", "TypeScript", 102, 0, 0, 24, 26, 152
"/Users/peaker/dev/solar-finance/src/stores/currency/currencyStore.ts", "TypeScript", 180, 0, 0, 30, 37, 247
"/Users/peaker/dev/solar-finance/src/stores/currency/defaultCurrencies.ts", "TypeScript", 50, 0, 0, 2, 2, 54
"/Users/peaker/dev/solar-finance/src/stores/currency/index.ts", "TypeScript", 3, 0, 0, 3, 1, 7
"/Users/peaker/dev/solar-finance/src/stores/currency/types.ts", "TypeScript", 25, 0, 0, 1, 3, 29
"/Users/peaker/dev/solar-finance/src/stores/system/constants.ts", "TypeScript", 35, 0, 0, 13, 4, 52
"/Users/peaker/dev/solar-finance/src/stores/system/index.ts", "TypeScript", 3, 0, 0, 2, 1, 6
"/Users/peaker/dev/solar-finance/src/stores/system/systemStore.ts", "TypeScript", 56, 0, 0, 34, 12, 102
"/Users/peaker/dev/solar-finance/src/stores/system/types.ts", "TypeScript", 24, 0, 0, 5, 4, 33
"/Users/peaker/dev/solar-finance/src/stores/theme.ts", "TypeScript", 71, 0, 0, 10, 10, 91
"/Users/peaker/dev/solar-finance/src/stores/transaction/defaultTransactions.ts", "TypeScript", 225, 0, 0, 8, 3, 236
"/Users/peaker/dev/solar-finance/src/stores/transaction/index.ts", "TypeScript", 4, 0, 0, 2, 1, 7
"/Users/peaker/dev/solar-finance/src/stores/transaction/transactionService.ts", "TypeScript", 72, 0, 0, 20, 11, 103
"/Users/peaker/dev/solar-finance/src/stores/transaction/transactionStore.ts", "TypeScript", 170, 0, 0, 45, 39, 254
"/Users/peaker/dev/solar-finance/src/stores/transaction/types.ts", "TypeScript", 30, 0, 0, 6, 8, 44
"/Users/peaker/dev/solar-finance/src/stores/user/defaultUsers.ts", "TypeScript", 35, 0, 0, 6, 1, 42
"/Users/peaker/dev/solar-finance/src/stores/user/index.ts", "TypeScript", 4, 0, 0, 2, 1, 7
"/Users/peaker/dev/solar-finance/src/stores/user/types.ts", "TypeScript", 16, 0, 0, 2, 2, 20
"/Users/peaker/dev/solar-finance/src/stores/user/userService.ts", "TypeScript", 110, 0, 0, 43, 20, 173
"/Users/peaker/dev/solar-finance/src/stores/user/userStore.ts", "TypeScript", 132, 0, 0, 45, 39, 216
"/Users/peaker/dev/solar-finance/src/types/base.ts", "TypeScript", 5, 0, 0, 0, 0, 5
"/Users/peaker/dev/solar-finance/src/views/AccountsView.vue", "Vue", 0, 22, 0, 1, 3, 26
"/Users/peaker/dev/solar-finance/src/views/DashboardView.vue", "Vue", 0, 221, 0, 4, 19, 244
"/Users/peaker/dev/solar-finance/src/views/DebugStoreView.vue", "Vue", 0, 643, 0, 4, 59, 706
"/Users/peaker/dev/solar-finance/src/views/MoreView.vue", "Vue", 0, 252, 0, 8, 33, 293
"/Users/peaker/dev/solar-finance/src/views/NotFoundView.vue", "Vue", 0, 32, 0, 1, 4, 37
"/Users/peaker/dev/solar-finance/src/views/PinLoginView.vue", "Vue", 0, 223, 0, 5, 37, 265
"/Users/peaker/dev/solar-finance/src/views/TransactionView.vue", "Vue", 0, 528, 0, 6, 87, 621
"Total", "-", 3606, 7014, 2654, 876, 2010, 16160