"filename", "language", "Vue", "TypeScript", "comment", "blank", "total"
"/Users/peaker/dev/solar-finance/src/views/transaction/TransactionView.vue", "Vue", -547, 0, -4, -82, -633
"/Users/peaker/dev/solar-finance/src/views/transaction/components/LoadingOverlay.vue", "Vue", 32, 0, 1, 3, 36
"/Users/peaker/dev/solar-finance/src/views/transaction/components/TransactionDialogs.vue", "Vue", 140, 0, 5, 10, 155
"/Users/peaker/dev/solar-finance/src/views/transaction/components/TransactionSelectors.vue", "Vue", 82, 0, 3, 9, 94
"/Users/peaker/dev/solar-finance/src/views/transaction/composables/index.ts", "TypeScript", 0, -6, -2, -1, -9
"/Users/peaker/dev/solar-finance/src/views/transaction/composables/useAdvancedDistribution.ts", "TypeScript", 0, -123, -28, -36, -187
"/Users/peaker/dev/solar-finance/src/views/transaction/composables/useDebtTransaction.ts", "TypeScript", 0, 253, 87, 48, 388
"/Users/peaker/dev/solar-finance/src/views/transaction/composables/useDistribution.ts", "TypeScript", 0, 146, 74, 45, 265
"/Users/peaker/dev/solar-finance/src/views/transaction/composables/useDistributionControl.ts", "TypeScript", 0, -67, -32, -16, -115
"/Users/peaker/dev/solar-finance/src/views/transaction/composables/useExchangeTransaction.ts", "TypeScript", 0, 149, 43, 30, 222
"/Users/peaker/dev/solar-finance/src/views/transaction/composables/useRegularTransaction.ts", "TypeScript", 0, 178, 36, 24, 238
"/Users/peaker/dev/solar-finance/src/views/transaction/composables/useTransaction.ts", "TypeScript", 0, -139, -27, -27, -193
"/Users/peaker/dev/solar-finance/src/views/transaction/composables/useTransactionCore.ts", "TypeScript", 0, 162, 47, 31, 240
"/Users/peaker/dev/solar-finance/src/views/transaction/composables/useTransactionManager.ts", "TypeScript", 0, 223, 38, 31, 292
"/Users/peaker/dev/solar-finance/src/views/transaction/composables/useTransactionSaver.ts", "TypeScript", 0, -325, -62, -57, -444
"/Users/peaker/dev/solar-finance/src/views/transaction/composables/useTransferTransaction.ts", "TypeScript", 0, 138, 41, 26, 205
"Total", "-", -293, 589, 220, 38, 554